1,1,1,1,1,1,1,1,1,17,17,17,17,1,1,1,1,1,1,1
1,1,1,1,1,1,1,1,1,17,2,3,17,1,1,1,1,1,1,1
1,1,17,17,17,17,17,17,1,17,1,17,17,1,1,1,1,1,1,1
1,1,17,1,1,1,1,17,1,17,1,17,17,17,17,1,1,1,1,1
1,1,17,1,17,17,1,17,1,17,1,1,1,1,17,1,1,1,1,1
1,1,17,1,17,17,1,17,1,17,1,17,17,17,17,1,1,1,1,1
1,1,17,1,17,17,1,17,17,17,13,17,1,1,1,1,1,1,1,1
1,1,17,1,1,1,1,1,1,1,13,17,17,17,17,17,17,1,1,1
1,1,17,1,17,17,17,17,17,17,1,1,1,1,1,1,17,1,1,1
1,1,17,1,17,1,1,1,1,17,1,17,17,17,17,1,17,1,1,1
1,1,17,1,17,1,1,1,1,17,1,17,1,1,17,1,17,1,1,1
17,17,17,17,17,17,17,17,17,17,17,17,17,17,17,17,17,17,17,17
0,0,0,0,0,0,0,0,0,0,0,0,0,0,0,0,0,0,0,0
17,17,17,17,17,17,17,17,17,17,17,17,17,17,17,17,17,17,17,17
1,1,1,1,1,1,1,1,1,1,1,1,1,1,1,1,1,1,1,1