18,18,19,19,19,18,18,18,19,18,18,18,18,19,19,19,19,19,19,19
18,19,19,18,18,18,18,18,18,18,18,18,19,19,18,18,18,18,18,19
19,19,18,18,18,19,19,19,19,19,19,19,18,18,18,18,18,18,18,19
19,18,18,18,18,19,18,18,18,18,19,19,19,18,18,18,18,18,18,19
18,18,18,19,19,19,18,18,18,18,18,18,18,18,18,18,18,18,18,19
18,18,18,19,18,18,18,19,18,18,18,19,18,18,19,19,19,19,19,19
18,18,18,19,18,18,18,19,18,18,19,19,18,18,13,18,18,18,13,19
18,18,18,18,19,19,19,19,18,2,19,19,3,18,19,19,19,19,19,19
19,18,18,18,18,18,18,19,18,18,18,19,18,18,18,18,18,18,18,19
19,19,18,18,19,19,18,18,19,18,18,18,19,18,18,18,19,19,18,19
18,19,19,18,18,19,18,18,19,19,18,18,19,18,18,18,19,18,18,19
18,18,19,18,18,19,18,18,18,18,19,19,19,18,18,18,19,18,18,19
18,18,19,19,18,18,18,18,18,18,18,18,19,18,18,18,18,18,18,19
18,18,18,19,19,18,18,18,19,19,18,18,18,19,19,18,18,18,18,19
18,18,18,18,18,18,18,19,19,18,18,18,18,18,19,19,19,19,19,19