4,4,4,4,4,4,4,4,4,4,4,4,4,4,4,4,4,4,4,4
4,7,7,7,7,7,7,7,7,7,7,7,7,7,7,7,7,7,7,4
4,7,7,7,7,7,7,7,7,7,7,7,7,7,7,7,7,7,7,4
4,7,7,7,7,7,7,7,7,7,7,7,7,7,7,7,7,7,7,4
4,5,11,11,11,6,5,6,5,6,5,6,5,6,5,11,11,11,11,4
4,13,11,11,11,11,11,11,11,11,11,11,11,11,11,11,2,11,11,4
4,13,11,11,11,11,11,11,11,11,11,11,11,11,11,11,3,11,11,4
4,8,8,8,8,8,8,8,8,8,8,8,8,8,8,8,8,8,8,4
4,8,8,8,8,8,8,8,8,8,8,8,8,8,8,8,8,8,8,4
4,8,8,8,8,8,8,8,8,8,8,8,8,8,8,8,8,8,8,4
4,8,8,8,8,8,8,8,8,8,8,8,8,8,8,8,8,8,8,4
4,8,8,8,8,8,8,8,8,8,8,8,8,8,8,8,8,8,8,4
4,8,8,8,8,8,8,8,8,8,8,8,8,8,8,8,8,8,8,4
4,11,11,11,11,11,11,11,11,11,11,11,11,11,11,11,11,11,11,4
4,4,4,4,4,4,4,4,4,11,11,4,4,4,4,4,4,4,4,4