14,14,14,14,14,14,15,15,15,15,15,15,15,15,15,15,15,15,15,15
14,15,15,15,15,14,15,15,15,15,15,14,14,14,14,14,14,15,15,15
14,15,15,15,15,14,15,15,15,15,15,14,15,15,15,15,14,15,15,15
14,15,15,15,15,14,15,15,14,14,14,14,14,15,14,15,14,15,15,15
14,15,15,15,15,14,14,14,14,15,15,14,15,15,14,15,14,15,15,15
14,15,15,15,15,15,15,15,15,15,15,14,13,15,14,15,14,14,14,15
14,14,14,14,14,14,14,14,14,15,15,14,13,15,15,15,15,15,14,15
15,15,14,15,15,15,15,15,14,15,15,14,17,14,14,14,15,15,14,15
15,15,14,15,15,14,15,15,14,15,15,14,14,14,15,14,15,15,14,15
15,15,14,15,15,14,15,15,15,15,15,15,15,15,15,15,15,15,14,15
15,15,14,15,15,14,15,15,14,14,15,15,15,15,15,14,14,14,14,15
15,15,14,15,15,14,15,15,15,14,15,14,14,14,3,2,14,15,15,15
15,15,14,15,15,14,15,15,15,14,15,15,15,15,15,15,14,15,15,15
15,15,14,15,15,15,15,15,15,15,15,14,14,14,15,15,14,15,15,15
15,15,14,14,14,14,14,14,14,14,14,14,15,14,14,14,14,15,15,15