14,14,14,14,14,14,15,15,15,15,15,15,15,15,15,15,15,15,15,15
14,15,15,15,15,14,15,15,15,15,15,14,14,14,14,14,14,15,15,15
14,15,2,3,15,14,15,15,15,15,15,14,15,15,15,15,14,15,15,15
14,15,15,15,15,14,15,15,14,14,14,14,14,15,14,15,14,15,15,15
14,15,15,15,15,14,14,14,14,15,15,14,15,15,14,15,14,15,15,15
14,15,15,15,15,15,15,15,15,15,15,14,15,15,14,15,14,14,14,15
14,14,14,14,14,14,14,14,14,15,15,14,15,15,15,15,15,15,14,15
15,15,14,15,15,15,15,15,14,15,15,14,15,14,14,14,15,15,14,15
15,15,14,15,15,14,15,15,14,15,15,14,14,14,15,14,15,15,14,15
15,15,14,15,15,14,15,15,15,15,15,15,15,15,15,14,15,15,14,15
15,15,14,15,15,14,15,15,14,14,15,15,15,15,15,14,14,14,14,15
15,15,14,15,15,14,15,15,15,14,14,14,14,14,13,13,14,15,15,15
15,15,14,15,15,14,15,15,15,14,15,15,15,15,15,15,14,15,15,15
15,15,14,15,15,15,15,15,15,15,15,14,14,14,15,15,14,15,15,15
15,15,14,14,14,14,14,14,14,14,14,14,15,14,14,14,14,15,15,15