14,14,14,14,14,14,14,15,14,14,14,14,14,14,15,14,14,14,14,14
14,15,15,15,15,15,14,15,14,15,15,15,15,14,15,14,15,15,15,15
14,15,15,15,15,15,15,15,14,15,15,15,15,14,15,14,15,15,15,15
14,15,15,15,15,15,14,15,14,15,15,15,15,14,15,14,15,15,15,15
14,14,14,14,14,14,14,15,14,14,15,15,14,14,15,14,14,14,14,15
14,15,15,15,15,5,6,5,6,5,6,5,6,5,6,15,15,15,14,15
14,2,15,15,15,15,15,15,15,15,15,15,15,15,15,15,13,10,14,15
14,14,14,14,14,14,14,14,14,14,14,14,14,14,14,14,14,14,14,15
14,15,15,14,15,15,15,15,15,15,15,15,15,15,15,14,15,15,15,15
14,15,15,14,15,15,15,15,15,15,15,15,15,15,15,14,15,15,15,15
14,15,15,14,14,14,15,15,15,14,14,14,14,15,15,14,15,15,15,15
14,15,15,15,15,15,15,15,15,14,15,15,15,15,15,14,15,15,15,14
14,15,15,14,15,15,15,15,15,14,15,15,14,15,15,15,15,15,15,14
14,15,15,14,15,15,15,15,15,14,15,15,14,15,15,15,15,15,15,14
14,14,14,14,14,14,14,14,14,14,15,15,14,14,14,14,14,14,14,14