1,1,1,1,1,1,1,1,1,17,17,17,17,1,1,1,1,1,1,1
1,1,1,1,1,1,1,1,1,17,13,13,17,1,1,1,1,1,1,1
1,1,17,17,17,17,17,17,1,17,1,17,17,1,1,1,1,1,1,1
1,1,17,1,1,1,1,17,1,17,1,17,17,17,17,1,1,1,1,1
1,1,17,1,17,17,1,17,1,17,1,1,1,1,17,1,1,1,1,1
1,1,17,1,17,17,1,17,1,17,1,17,17,17,17,1,1,1,1,1
1,1,17,1,17,17,1,17,17,17,2,17,1,1,1,1,1,1,1,1
1,1,17,1,1,1,1,1,1,1,3,17,17,17,17,17,17,1,1,1
1,1,17,1,17,17,17,17,17,17,1,1,1,1,1,1,17,1,1,1
1,1,17,1,17,1,1,1,1,17,1,17,17,17,17,1,17,1,1,1
1,1,17,1,17,1,1,1,1,17,1,17,1,1,17,1,17,1,1,1
17,17,17,17,17,17,17,17,17,17,17,17,17,17,17,17,17,17,17,17
0,0,0,0,0,0,0,0,0,0,0,0,0,0,0,0,0,0,0,0
17,17,17,17,17,17,17,17,17,17,17,17,17,17,17,17,17,17,17,17
1,1,1,1,1,1,1,1,1,1,1,1,1,1,1,1,1,1,1,1