18,18,19,19,19,18,18,18,19,18,18,18,18,19,19,19,19,19,19,19
18,19,19,18,18,18,18,18,18,18,18,18,19,19,18,18,18,18,18,19
19,19,18,18,18,19,19,19,19,19,19,19,18,18,18,18,18,18,18,19
19,18,18,18,18,19,18,18,18,18,19,19,19,18,18,18,18,18,18,19
18,18,18,19,19,19,18,18,18,18,18,18,18,18,18,18,18,18,18,19
18,18,18,19,13,18,18,19,18,18,18,19,18,18,19,19,19,19,19,19
18,18,18,19,13,18,18,19,18,18,19,19,18,18,2,18,18,18,3,19
18,18,18,18,19,19,19,19,18,18,19,19,18,18,19,19,19,19,19,19
19,18,18,18,18,18,18,19,18,18,18,19,18,18,18,18,18,18,18,19
19,19,18,18,19,19,18,18,19,18,18,18,19,18,18,18,19,19,18,19
18,19,19,18,18,19,18,18,19,19,18,18,19,18,18,18,19,18,18,19
18,18,19,18,18,19,18,18,18,18,19,19,19,18,18,18,19,18,18,19
18,18,19,19,18,18,18,18,18,18,18,18,19,18,18,18,18,18,18,19
18,18,18,19,19,18,18,18,19,19,18,18,18,19,19,18,18,18,18,19
18,18,18,18,18,18,18,19,19,18,18,18,18,18,19,19,19,19,19,19